11111111111111
10C00010000001
111100001110C1
1P000011E00001
11111111111111